CRO = "countries/Crownlands.txt"
NWA = "countries/Nights Watch.txt"
WIL = "countries/Wildlings.txt"
CRA = "countries/Crasters Keep.txt"
VAL = "countries/Vale.txt"
NOR = "countries/North.txt"
WES = "countries/Westland.txt"
IRO = "countries/Iron Islands.txt"
DOR = "countries/Dorne.txt"
RIV = "countries/Riverland.txt"
STO = "countries/Stormland.txt"
REA = "countries/Reach.txt"
FF1 = "countries/FF1.txt"
FF2 = "countries/FF2.txt"
FF3 = "countries/FF3.txt"
FF4 = "countries/FF4.txt"
FF5 = "countries/FF5.txt"
FF6 = "countries/FF6.txt"
ICE = "countries/WhiteWalker.txt"

DRA = "countries/Dragonstone.txt"
STE = "countries/Stepstones.txt"
BWB = "countries/Brotherhood Without Banners.txt"
BOL = "countries/Bolton.txt"

SUI = "countries/Summer Islands.txt"
BRA = "countries/Braavos.txt"
LOR = "countries/Lorath.txt"
OMB = "countries/Omber.txt"
QOH = "countries/Qohor.txt"
MOR = "countries/Morosh.txt"
SAA = "countries/Saath.txt"
VOL = "countries/Volantis.txt"
LYS = "countries/Lys.txt"
PEN = "countries/Pentos.txt"
MYR = "countries/Myr.txt"
TYR = "countries/Tyrosh.txt"
IBB = "countries/Ibben.txt"
NAA = "countries/Naath.txt"
MRQ = "countries/Moraq.txt"
YTI = "countries/Yi Ti.txt"
ASS = "countries/Asshai.txt"
QAR = "countries/Qarth.txt"
LEN = "countries/Leng.txt"
ULT = "countries/Ulthos.txt"
SOT = "countries/Sothoryos.txt"
AST = "countries/Astapor.txt"
TOL = "countries/Tolos.txt"
ELY = "countries/Elyria.txt"
MAN = "countries/Mantarys.txt"
DOT = "countries/Dothraki.txt"
SLA = "countries/Slavers Bay.txt"
YUN = "countries/Yunkai.txt"
MER = "countries/Meereen.txt"
REW = "countries/Red Waste.txt"
UNL = "countries/Unknown Lands.txt"
TAR = "countries/House Targaryen.txt"

NRV = "countries/Norvos.txt"
VLY = "countries/Valyria.txt"
GHI = "countries/New Ghis.txt"

GER = "countries/Germany.txt"
ITA = "countries/Italy.txt"
SOV = "countries/Soviet Union.txt"
FRA = "countries/France.txt"
ENG = "countries/United Kingdom.txt"
USA = "countries/USA.txt"
JAP = "countries/Japan.txt"
MEN = "countries/Mengkukuo.txt"
#MAN = "countries/Manchukou.txt"
CHI = "countries/China.txt"
PRC = "countries/ComChina.txt"